NO textures/wall_1.xp
SO textures/wall_2.xpm
WE textures/wall_3.xpm
EA textures/wall_4.xpm

R 848 480
F 184,113,39
C 51,198,227
11111111111   1111111111111111111
10000000001111110000000000001     
101100000111   111100000000011111111
10010000000111111000000010001
10110000011100000000000010001
10000000001100000111011110001
11110111111111011100000010001
11110111111111011101010010001   111111
11000000110101011100000010001  1100001
100000000000000011000000100011  111111
100000000000000011010100100011111
110000001101010000001111100000001
111101111101010000001000100011111
10000000001100000100111110001
10000000000000001010000101001
10000000001000010001010001001
10000000001101000000E00000001
10000000000100000001010000001
11111111111111111111111111111
