    F       84,13,239
C                   174,35,221
        R           1600              800
NO          ./textures/wall_4.xpm
                    SO       ./textures/wall_4.xpm
            WE ./textures/eagle.xpm
 EA ./textures/eagle.xpm        
                            S  ./textures/sprite_3.xpm

11111111111111111111111111111
10000000001100200000000000001111111111
10110000011100000000000010000000000001
10010000000000000200000010001111111001
10110000011100000000000010001     1001
10000000001100000111011110001     1001
11110111111111011100000010001     1001
11110111111111011101010010001     1001
11000000110101011100000010001     1001
10000000000000001100020010001     1001
10000200000000001101010010001     1001
11000000110101000000000000001111111001
11110111110101000000200000000000000001
10000000001100000100000010000000000001
10000200000000001010000101001111111111
10000000001000010001010001001
10000000001101000000000020001
10000N00000100000001010000001
11111111111111111111111111111
11111111111111111111111111111