R 1920 1080
NO textures/wall_1.xpm
SO textures/wall_2.xpm
WE textures/wall_3.xpm
EA textures/wall_4.xpm
S textures/sprite_2.xpm
F 184,113,39
C 0,0,0 
 
        11111111111111111111111111111
       110000000000000S000000000000011
      110000000000000000000000000000011
     11000000000000000200000000000000011
    1100000000000000000000000000000000011
   110000000000000020000020000000000000011
  11000000000000000000000000000000000000011
   110000000000000000000000000000000000011
    1100000000000002000002000000000000011
     11000000000000000000000000000000011
      110000000000000020000000000000011
       1100000000000000000000000000011
        11111111111111111111111111111
